 lax : (행동 등이) 느슨한, 규율에 못 미치는 
 procrastinate : 미루다, 꾸물거리다 
 combined : 결합된, 합동의 
 accomplish : 성취하다 
 voluntarily : 자발적으로 
 undertake : (일을) 떠맡다 
 assume : (증거는 없으나) 사실이라고 생각하다;(책임, 역할을)맡다 
 occasionally : 가끔, 때때로 
 employee : 직원, 고용인 
 assist : 돕다, 조력하다 
 satisfied : 만족하는 
 manner : 방식;태도 
 responsible : 책임이 있는 
 conduct : 수행하다 
 adjust : 적응하다 
 personnel : 직원, 인원; 인사과 
 agree : 동의하다 
 supervise : 감독하다, 지도하다 
 coworker : 동료, 협력자 
 direct : ~에게 길을 안내하다, 가르쳐주다 
 confidential : 기밀의, 내밀한 
 assign : 배정하다, 할당하다 
 leading : 선도적인, 일류의 
 formal : 격식을 갖춘 
 remove : 해임하다, 제거하다 
 collect : 모으다, 수집하다 
 coordinate : 조정하다 
 hardly : 거의 ~하지않다 
 abstract : 추상적인 
 directory : 주소록 
 accountable : 책임이 있는 
 skillfully : 능숙하게, 솜씨 있게 
 exclusive : 독점적인; 배타적인 
 intention : 의지, 의향 
 transform : 바꾸다 
 respectful : 정중한, 존중하는 
 duplicate : 사본 
 contrary : 반대 
 disturbing : 충격적인, 불안감을 주는, 방해하는 
 engage : 관여하다, 종사하다 
 foster : 촉진하다, 육성하다 
 neutrality : 중립성, 중립 
 widely : 널리 
 externally : 외부에서, 외부적으로 
